BSBUBSCl
BUBSBUCU
BSBlBUCU
BlBUCUCS
CUCSCNBl
BlBUBlBU
BSBUBSCU
BUCUCSCU
BSCUCSCU
BUBSCSCU
BSBUCUCS
BUBlBSBU
BSCSCUCl
CUCNBlBS
CSCUCNBl
BUClCUCS
BSBSBUCl
ClCUCSCU
ClCUCSCS
BUBlBUCU
BUCUCSCS
BlBUCUCl
CSCUClCU
CUClCUCS
other
CNBlBUBS
CUCSCUCS
BUBlBUBS
BUClCUCN
CNBlBUCU
BSClCUCN
BUBSBUBS
BUBSBUCl
CNBlBSBU
CSCUCSCU
BUBSBSBU
CSCSCUCS
BUBSBUBl
BlBSBUCU
BlBUCUCN
CNBlBUBl
BSBUClCU
CSCUCSCN
BlBSBUBl
CUCNBlBU
CNBlBUCl
BSBUCUCN
BSBUBlBU
CSCSCUCN
BUCUClCU
BSBSBUBl
BUBSClCU
BlBUClCU
CUCSCUCN
BUBSCUCS
CUCSCSCU
BSClCUCS
BlBUBSBU
BlBUBSBS
ClCUCNBl
BSBUBSBl
CSCNBlBU
CUClCUCN
CSCUCSCS
BSBSBUBS
BSBUBSCS
BUBSBlBU
BSBUBSBU
BSBUBlBS
BUCUCNBl
