CCCUCSCS
CUCDDUDN
CUCSCDCU
BUClCSCS
DUDSDSDS
DUDSDUDC
CUDUDSDS
BUBDBUCU
DUDFDFDF
CCCUCFCU
BSBUCUCS
BCBUCUCD
CFCFCFCF
DCDUDSDU
ClCSCUCS
BlBUBCBF
CUCFCUCD
BSBUBCBU
CUCSCSCS
BUBlBNBU
CDCUCCCF
DUDDDNBl
BFBSBSBU
BUBSBSBS
CUDUDCDU
BUBSBUBS
CUCCCUCF
CSCUDSDU
CSCSCUDU
BlBUBlBU
DNBlBSBU
DlDNDUDN
CDCUClCU
DUDNBlBU
CSCUCSCS
CFCUCSCS
BSBSBUCl
DUDCDUDD
BlBUCUCS
DSDUDSDU
BUBDBUBS
DSDSDUDN
BUClCCCU
BSBUClCS
DNBlBUCl
CUClCUCN
BUBSBUBC
BlBUBSBS
BUCSCUCS
BUClCUCC
CNCUDUDS
CCCUCSCU
BUBCBUCU
BSCUCCDU
BUCUCCCS
BSBUBSCS
DFDFDUDF
DUDSDSDU
ClCSCSCU
DUDlDNDU
CCCUCSCD
BCBUBDBU
DUDCDUDS
BUBCBFBF
BlBUCUCC
CCCFCFCU
CSCUCDCU
CUDUDDDU
CSCUDUDC
BSBSBUBl
CUClCNCU
DNBlBUCU
CSCUCSCU
CUCNCUCS
CUCSCUDU
ClCUCNCU
BUBSCSCU
BlBUBSBC
CSCUClCN
BUClCUCS
DUDFDDDN
BlBUClCC
BUBSBUBl
BlBSBUBS
BSBUBSBF
CUClCUCS
CUCDCUDU
CSCUClCU
CUCCCFCD
CUCSDUDN
BUBlBUBS
BlBNBUCl
DFDFDFDU
DCDUDDDU
CSCUDUDS
BUBSBUCS
CUCCCUCS
CSCSCUCF
CSCSCSCU
CDCUCCCU
CUCDCUCl
CUCSCUCF
CUCDCUCS
DDDNBlBU
CSCUCCCU
CFCUCSCU
DUDNBlBS
DFDUDFDD
BSBFBFBS
BFBSBFBF
CNCUCSCS
CUClCUCC
BUCUClCU
CUDUDNBl
BlBUClCU
CUCDCUCC
CSCUClDN
CFCUCSCF
DSDUDCDU
CDDUDNBl
CUCCCFCF
BSBUBlBU
BFBFBSBS
BUBSBFBF
CUCSCUDS
CUCCCFCU
BFBFBFBF
CFCFCUCD
CSCFCUCS
BSBUBSBS
CUDSDUDS
CDCUCSDU
BUBCBUBD
CFCFCFCU
DSDSDSDS
CCCSCUCS
BSBUCSCU
BlBUBCBU
CDCUDUDl
CUCFCUCS
CUClDNDU
CUCCCUCD
BSBFBFBF
ClCUCSCU
BUCUCSCS
BSBSBSBU
other
BlBUCUCl
CFCUCDDU
CUCCCUDU
CCDUDDDN
ClCUCCCU
CFCUCFCU
DSDUDSDN
CSCSCSCS
DUDSDUDN
BlBUBlBN
DSDSDUDS
DNDUDSDS
CUDUDCDF
CSCUCFCU
CSCSCUCS
CUCCCSCU
CCCFCFCF
BUCUCCCF
CUCSCUCD
BSBUCUCC
BFBFBUBD
BUCUCDCU
BNBUClCS
CUCSCFCU
DFDUDFDF
ClCUCCCF
BFBDBUCU
CDCUDUDS
BSBSBUBS
ClCNCUDU
BSBSBUCU
DCDFDUDF
BUClCSCU
CSCSCUCC
DSDNBlBU
CDCUCSCU
BUBSBSBU
DDDUDNBl
BDBUCUCS
DNBlBUBC
ClCCCUCS
CFCUCFCD
CUCSCUCC
BFBFBFBD
BlBUBSCU
BFBFBDBU
CUDUDSDU
CFCFCUCF
BUBSCUCC
BUCUCSCU
BDBUBSBU
CUDUDlDN
BUBSBUCU
BSBSBSBS
DNBlBUBS
DUDSDNBl
CCCFCUCD
ClCUCSCS
BUBlBUCU
CCCUCFCD
ClDNDUDS
DFDFDFDF
BSBUBSBU
CSDUDNBl
BCBSBFBS
CUCSCUCS
DNBlBUBl
BUBSBCBS
CCCFCDCU
DUDCDFDU
CSCSCUCD
DSDUDNBl
BSBUCUCl
BFBUBDBU
DNDUDNBl
DSDSDSDU
CUCSCUCl
CSCDCUDU
CUCFCUCF
CUCFCDCU
CUCCDUDD
CSCUDUDN
CFCUCDCU
CCCUCDCU
DUDSDUDS
BUBSBUCl
BSCSCUCS
BSBUClCU
BSBFBSBF
BSBCBSBF
CUCSCSCU
DSDUDSDS
BlBUBSBU
DUDDDUDN
CDCUDUDN
CCCUDUDD
BCBFBFBU
DFDDDNBl
CFCDCUDU
