CCCUCSCS
CNBlBUBC
BUBlBUBN
BDBUCCCS
BSCDCCCD
BSBDBCBD
CFCDCCCD
BUBCBDBU
CCCSCSCD
BUCCCDCU
BFBUBFBD
BlBUBSBS
BCBSCDCC
BDBUCUCl
CCCUCFCU
BDBUCCCD
CDCSCNCC
BDCUCCCD
CDCCCUCN
CFCUCDCC
CSCSCUCD
BCBSBDBC
BlBUBCBF
BDBCBUBS
CUCFCUCD
BCCDCUCC
BCBDBUBC
BDCCCDCS
BSBUBCBU
CCCUCDCC
BUBDBUBC
CUCNBlBC
CDCCCFCD
BUBSBDBU
CDCUCCCF
BUBDBUBS
CDCCCSCD
BUBSBCBD
CDCNBlBU
BUBSBUBS
CUCCCUCF
BUBSBUBD
BFBUCUCD
CUCSCSCN
CCCDCCCF
CDCSCSCC
BlBUBDBC
CUCDCSCC
CNBlBUBD
CCCDCCCU
CSCDCUCC
BCBUCDCU
BCBDCCCD
BDBUBCBU
BUCUClCC
BCBSBDBS
BDBUBlBU
BSBCBDBU
BUBDBCBU
BCBDCCCU
BSBSBCBU
BDBUCSCU
BFBDBUBS
CCCUCDCS
BCBDBCBF
BUCSCSCU
CUCFCDCS
CUCNCUCC
ClCNCNBl
CFCDCUCN
CFCDCUCS
BUBSBUBC
CFCFCDCU
BSBCBSBD
BUBCBFBU
BUBSBCBU
BUBCBSBU
ClCCCDCC
BNBUCUCC
CUCCCDCU
CDCCCUCF
BUBDBCBS
CNCNBlBU
CNBlBCBD
BFBUBDBC
CUCCCFCU
BCBUBDBU
CCCSCSCU
BDBCBFBD
CSCNCCCD
BDBCBUBF
BCBDBUCS
CSCUCDCU
BFBDBUBC
CDCNBlBC
CUCNBlBl
CUCCCUCS
CUClCNCN
BSBUBCBD
CSCDCCCU
BDBCBDBU
CDCUCSCN
BlBUBSBC
CFCFCFCD
BFBUBDBU
BCBFBUCU
BUBCBDBS
BUBDBUBl
BlBUBCBD
BUBDBUCC
BCBUBSBU
BDCCCDCU
BUCCCSCU
CCCSCSCS
BUBFBDBU
CUCCCFCD
BUBCBDBC
CDCUCCCD
CUCDCUCS
CSCSCSCU
BCBDBUCC
CCCDCUCC
CSCUCSCU
BUBCBDCC
CUCCCUCD
BSBDBSBU
CNCCCDCC
CDCUCCCU
BDBUBCBF
CCCUCNBl
CUCDCCCD
CSCNBlBC
CFCUCDCS
CSCUCCCU
BCBSBDBU
BUBDBUCS
BDBCBDBC
BDBUCSCS
BUCUCCCU
BUCSCUCC
CUCDCSCN
CUCSCUCN
CUCDCUCC
CUCSCDCN
BSBCBUBF
BCBUBFBU
BUBDBSBS
CNBlBCBU
CUCCCUCC
CDCSCSCU
CUCCCFCF
CUCCCSCS
CSCUCDCC
BSBDBUBC
CDCCCUCD
BCBDBUCU
BCBUCDCC
BlBUBNBU
CUCFCDCU
BDCUCCCU
CCCUCSCD
CDCCCDCS
CUCDClCU
BCBUBDBS
CCCFCFCD
BCBDCSCU
BUBSBSBS
CUCSCNBl
BDBUBCCD
CSCDCCCF
BUBCBUBD
CUCCCDCC
BFBDBUCC
BCBUBFBD
BDBCBSCD
CFCUCDCU
BSBCBUBD
ClCUCNCU
BlBUBCBU
CUCFCDCC
CCCUCDCl
BDBSBCBD
CSCCCDCC
CCCDCCCD
CSCSCNBl
CDCUCNBl
BSBDBUBS
BSBSBSBU
CNBlBUBS
CCCDCSCS
other
BCBFBUBF
BDBSBSBC
BCBUBDBC
CSCUClCN
BSBUBSBC
CSCDCNBl
CDCCCDCN
CNCUCCCD
CSCUCCCD
CCCSCDCC
CCCDCUCN
BDCCCUCD
BCBUBDCC
CCCDCUCS
CUCDCCCF
CCCFCFCF
BDBUBCBD
BDBUCUCC
BDBCBUBD
BUBCBSBD
CSCSCDCC
BSBUBDBU
BDBSBUBS
BDBUBCBS
BUCDCCCU
CUCCCDCS
BCBDBSBC
CUCDCCCS
BDBCBDCC
CCCUCCCU
CFCDCSCS
CDCCCDCU
CSCUCCCF
BUBCBUBS
CSCCCUCD
BDBUBSBU
BSBUBDCU
BDCSCUCC
CSCNBlBU
CSCSCUCC
BNBUBSBS
CDCSCUCC
CDCUCSCU
BSBUBSBU
BDBUCUCS
BUBCBDCU
CUCSCUCC
CCCSCUCl
CNBlBlBN
BUCDCUCC
BUBDCUCC
CFCDCUCC
CUCSCSCC
BUCUCSCU
BCBSBUBD
BDBCBDCS
BlBNBUBS
BDBSBCBU
BUCUCDCU
BDBUCCCF
CCCDCSCU
BSBSBUBC
BUBNBUCU
BlBUBCBS
CSCUCNBl
BSBCBDBC
CCCFCUCD
CCCUCFCD
CDCSCUCS
BDBCBUCD
CUCDCUCN
CCCDCNBl
BCBDBCBU
CFCDCNBl
CUCSCUCS
BUCCCDCC
CDCSCCCD
BUBSBCBS
CCCFCDCU
BlBCBFBD
BlBlBNBU
CUCDCNBl
BUBDCCCD
CDCCCSCS
CDCCCFCU
CDCSCCCU
CUClCCCD
CDCUCCCS
BUBCCDCU
BCBDCUCC
CDClCUCN
BUBDBUCU
CSCUCSCN
BCBFBDBU
CSCCCDCU
CUCNBlBU
BUCUCCCD
CFCFCDCN
CSCSCCCU
CCCUCDCU
BCBDBCBD
CCCFCDCS
CCCDCCCS
BUBFBUBD
CUCDCCCU
CCCUCDCN
BDBUBSBC
BlBCBUBD
CUCSCSCU
BSBUBSBD
BlBUBSBU
CSCSCCCD
CFCDCSCU
CDCCCDCC
BlBCBDBU
CUCDCSCU
CCCSCDCU
CUCCCDCN
BCBDBUBS
BUBDBCBD
BUCCCFCD
CNBlBCBF
CDCUCSCS
BCBUBDCU
