CNBlBUBC
BUBFBFBF
BCBFBFBD
CDCCCDCC
CFCDCCCD
BSBUBSCU
BFBUBFBD
CSCFCFCU
CFCFCDCC
CSCFCSCF
BlBUBCBF
CFCSCFCF
CUCFCUCD
BUBDCUCF
CUCFCSCU
CCCUCFCF
BSBUBCBU
BUBDBUBC
BUCUCDCU
CNBlBUBS
CFCUCFCU
BUBSBSBS
CNBlBUCU
BUBSBUBS
CUCCCUCF
CCCUCSCF
CFCUCFCD
CNBlBSBS
BlBCBFBF
CCCDCCCU
BUBDBUCU
CSCUCSCS
CSCSCNBl
BlBUCUCS
BFBDBUBS
CUCFCFCU
BUCFCFCS
BFBFBUBS
CUCFCDCU
BUBSBUBC
BlBUBSBS
BUCSCUCS
BUBCBFBU
CCCUCSCU
CDCCCUCF
CUCCCFCU
CUCFCFCD
BUBCBUBF
BUBCBFBF
BlBUCUCC
CCCFCFCU
CFCFCDCU
CSCUCDCU
BFBDBUBC
BSBUBCBF
CUCCCUCS
CFCSCFCU
BFBUBFBF
CDCUCSCN
CSCSCSCN
CFCFCFCD
CFCFCFCF
BUBFBUBD
BFBUCFCF
BlBSBSBU
CNBlBUCS
other
BUBFBDBU
BlBUBFBU
CUCDCUCS
BUBFBUCU
CUCFCDCS
BFBFBUCF
CFCDCUCN
BUBFBSBF
BUBSBUCS
CSCUCSCU
BlBFBFBF
CSCSCSCU
CFCUCFCF
BDBUBCBF
CUCSCUCF
BUBFBUBF
CFCUCSCU
BSBUCUCN
BDCUCFCU
CSCSCUCN
CCCFCUCF
CDCUCCCF
BSBUBSBU
CUCSCUCN
CUCDCUCC
BFBUBSBU
CDCUCNBl
BCBUBFBU
BFBSBFBU
CSCUCCCU
CUCCCFCF
CUCFCFCF
CUCFCFCS
BFBFBFBF
CFCFCUCD
BCBUBFBF
BSBUBSBS
CUCSCNBl
CFCSCFCS
BUBFBFBU
CFCFCFCU
BSBUCSCU
BlBUBCBU
CUCNBlBC
CUCFCUCS
BUCUCSCS
BFBUBFBS
BSBSBSBU
BCBFBUBF
CSCFCUCD
CSCSCSCS
BFBUBDCU
CSCUCFCU
CSCSCUCS
CCCFCFCF
BDBUCUCC
BSBUCUCC
BUCUCCCF
CUCSCUCD
CFCDCUCS
BFBFBUBD
CUCSCSCS
CUCNBlBF
BFBDBUCU
BSBSBUBS
CSCUCCCF
BSCUCCCF
BlBUCSCU
BSBSBUCU
CSCNBlBU
CSCSCUCC
CDCUCSCU
BUBSBSBU
CDCUCSCS
BDBUCUCS
BCBFBFBF
BSBFBUBF
CUCSCUCC
BFBFBFBD
BFBFBDBU
CFCFCUCF
BUBSCUCC
BUCUCSCU
BDBUBSBU
CFCFCFCS
BSBSBUBC
CNBlBFBF
BUBSBUCU
CUCNBlBS
BSBSBSBS
CSCUCNBl
BFBUBFBU
CUCSCFCF
CCCUCFCD
CDCSCUCS
CNBlBUBF
CUCSCUCS
BFBUCUCD
CSCUCFCF
BSBUCUCS
CFCUCFCS
BFBUBDBU
CSCUCSCN
CUCFCUCF
CUCNBlBU
CFCUCDCU
BFBFBUBF
CUCSCSCU
CSCFCFCF
BlBUBSBU
CFCDCSCU
BCBFBFBU
BFBFBFBU
CNBlBCBF
CFCFCSCF
CFCSCUCF
BUCUCNBl
