CSCSCSCN
BSBUBSBS
CUCSCNBl
BUBSBUCS
BSBUBSCU
BUCUCSCU
BUBSBUBS
BUCSCUCS
BSBUCSCU
BSCUCSCS
CNBlBSBS
BSBSBSBS
BlBSBSBU
CSCUCNBl
BSCUCNBl
BSBUCSCS
BSBSBSCU
BUCUCSCS
BSBSBSBU
CNBlBUCS
BlBSBUBS
other
CNBlBUBS
CUCSCUCS
BUCSCSCU
BUBSBSBS
CNBlBUCU
CSCSCSCS
BSBUCUCN
BSBUCUCS
CNBlBSBU
CSCUCSCU
BUBSBUCU
CSCSCUCS
BUCSCSCS
CSCSCSCU
BSBSCUCN
CSCUCSCS
CSCUCSCN
CSCSCNBl
CUCNBlBU
BlBUCUCS
BSBSBUCS
CUCSCSCS
CSCSCUCN
CUCNBlBS
BSBUBSBU
CUCSCUCN
BUBSCUCS
CUCSCSCU
BSBSBUBS
BlBUBSBU
BlBUBSBS
BSBSBUCU
CSCNBlBU
BlBUCSCS
BUBSBSBU
BUCUCNBl
