CSCNBlBS
CNBlBUCS
BlBUCUCS
BSBUBSBS
CUCSCNBl
BUBSBSCU
BUCUCSCU
BlBUCSCU
BUCUCNBl
CNBlBSBS
BlBSBSBS
BSBSBSBS
CSCSCSCN
CSCUCNBl
CSCNAlBN
BUCUCSCS
BSBSBSBU
BSBUBSBU
BlBSBUBS
other
CNBlBUBS
CUCSCUCS
BUBSBSBS
CNBlBUCU
BUBSBUBS
BSBUCUCS
CNBlBSBU
CSCUCSCU
BUBSBUCU
CSCSCUCS
CUCSCSCN
CSCSCSCU
AlBNBlBU
BSBSCUCN
CSCUCSCS
CSCUCSCN
CSCSCNBl
CUCNBlBU
BSCUCNBl
BSBUCUCN
CUCSCNAl
CUCSCSCS
CSCSCUCN
CUCNBlBS
CSCSCSCS
CUCSCUCN
CUCSCSCU
BSBSBUBS
BlBUBSBU
BlBUBSBS
BUCSCUCS
BSBSBUCU
CSCNBlBU
BNBlBUBS
BUBSBSBU
CNAlBNBl
