BUBSBSBS
CUCSCNBl
BUBSCUCN
CNBlBSBU
BSBUBSCU
BUCUCSCU
BUCSCUCN
BSBUCSCU
BlBUCSCS
BlCSCUCS
CSCUCNBl
BSCUCNBl
BUCUCSCS
BSBSBSBU
CNBlBUCS
BlBSBUBS
other
CNBlBUBS
CUCSCUCS
BUCSCSCU
BSBUBSBS
CNBlBUCU
BUBSBUBS
CNBlCSCU
BSBUCUCS
BUBSBUCS
CSCUCSCU
BUBSBUCU
CSCSCUCS
CUCSCSCN
BlBSBUCU
CSCSCSCU
BlBUCUCN
CSCUCSCS
CSCUCSCN
CSCSCNBl
BUCUCNBl
BlBUCUCS
BSBUCUCN
CUCSCSCS
CSCSCUCN
CUCNBlBS
BUBSBSBU
CUCSCUCN
CUCNBlCS
CUCSCSCU
BSBSBUBS
BlBUBSBU
BlBUBSBS
BSBSBUCU
CSCNBlBU
BSBUBSBU
CUCNBlBU
