DNDNAlBN
DUBNBlBU
BlBUBlBU
BSBUBSCU
BSBUCUDN
CUCSCUDN
DUDNAlBN
BUBlBNBU
BUBSCUDl
CUDSDSDU
BUBSBUBS
CSCSCUDU
DNBlBSBU
DNDlDUBN
DUDNBlBU
ANBlBSBS
CUDNAlBN
CSCUCSCS
BlBUCUCS
ClCNCUCS
DNDlDUAN
CUDlDNDN
BUCNCUCS
DSDSDUDN
BlBUCNCU
DNBlBUCS
BlBUBlBN
CUClCNCU
DNBlBUCU
CUCNCUCS
ClCUCNDU
CUCSCUDU
CSDUDSDN
BlBSBUBS
other
CSCSCUDN
CSCUClCU
CSCSCUCl
CSCUDNBl
BlBSBUCl
DNBlBUBS
BSBUCUDU
CSCUCSCU
CSCUDNAl
BlBSBUCU
CSCSCSCU
AlBNBlBU
DNBlBSBS
DlDNDNAl
DUDNBlBS
CUDUDNBl
BUBSBSBU
DSDNBlBS
BNBlBUBS
CUDNBlBU
BNBlBUCU
CNDUDNDl
BSBUBSBS
BUCSCUCS
CUCNDUDN
BUCUDUDS
ClCUCNCU
BlBSBSBU
CUCSDUDS
BUCUCSCS
BSCUDlDN
BlBUCUCl
BNBUCSCU
DNAlBNBl
BUBNBUBS
DNDlANBl
DSDUDSDN
CNCUCSDU
BUBSBUCU
DNBlBNBl
DUDNDlDU
CNCUClCU
CUCSCSCS
BSBSBUBS
ClCNCUDU
CNCUDSDS
DlDUBNBl
CUClCUCN
CSCSCUCS
DSDNBlBU
CNCUCSCS
BSBUBSBU
BUCUDUDN
CUDUDNDl
CUDUDSDU
BlBUBNBU
BUCUCSCU
BlBUCSCU
BSBSBUCU
CNCUDUDN
BUCUClCN
ANBlBUCU
CUCNCUDU
DUDSDNBl
CSCUClCN
BUBlBUCN
BUBlBUBN
CUCSCUCS
DNBlBUBl
DlANBlBS
BUClCUCN
BUCUDNBl
BSBUCUCS
DUDNBlBN
DSDUDNBl
BlBNBUCS
DlDUANBl
CUCSCUCl
CUCNCUDS
CSCUDUDN
DUDSDUDS
BNBUBSBU
BSBUClCU
CUDUDNAl
CUCNCUCl
CUCSCSCU
DUDNDlAN
BlBUBSBU
DUANBlBU
BlBNBlBU
CNCUCSCU
