BSBUBSBS
BUBSBSCU
BUCUCSCU
BSCUCSCS
BSBSCUCS
BUBSBSBU
BSBSCSCU
BlBSBSBS
BSBSBSBS
CSCSCSCN
CSCUCNBl
BUCUCSCS
BSBSBSBU
BlBSBUBS
other
CNBlBUBS
CUCSCUCS
BUBSBSBS
CNBlBUCU
BUBSBUBS
BSBUCUCS
CNBlBSBU
CSCUCSCU
BUBSBUCU
CSCSCUCS
CUCSCSCN
BlBSBUCU
CSCSCSCU
CSCUCSCS
CSCSCNBl
CUCNBlBU
BlBUCUCS
BSBUCUCN
CUCSCSCS
CSCSCUCN
CUCNBlBS
BSCSCUCS
CSCSCSCS
CUCSCUCN
CUCSCSCU
BSBSBUBS
BlBUBSBU
BlBUBSBS
BSBSBUCU
CNBlBSBS
CSCNBlBU
BUBSBSCS
BSBUBSBU
BUCUCNBl
