CNBlBUBC
BlBUBlBU
BSBUCUDN
other
CUCSCUDN
CFCFCDCC
CFCFCFCF
BDBlCUCS
BlBUBCBF
CFCSCFCF
BUBlBNBU
CNBlBUBS
BlClCCCF
CNBlBUCU
ClCUCCCF
DNBlBUBS
DUDNBlBU
BUCUClCC
BlBUCUCS
DNBlBUCl
ClCSCUCN
ClCUDNBl
BUClCUCC
BlBUClCS
BUClCUDN
BUBCBFBF
CFCFCDCU
BlBUBlBN
BSBUCUDU
DNBlBUCU
BlCUCSCU
CFCDCCCF
CNCCCFCF
CFCFCFCD
BUClCUCS
DUDNBlCl
CUClCUCS
ClCUCSCN
CSCUDNBl
CDCCCFCF
CSCNBlBU
CFCDCUCN
BUBSBUCl
ClCCCFCF
CUCSDNBl
CFCUCFCF
BFBDBlCU
CUDUDNBl
BlBUClCU
CUCSCUCN
CFCDCUDN
BUBlCUCN
CUCCCFCF
CUCFCFCF
CUDNBlBU
BFBFBFBF
BlBUBNCU
CUCSCNBl
CFCFCFCU
BUCUDUDS
ClCUCSCU
CDCUCNBl
BlBUCUCl
BlBUBSCC
BlCUCNBl
CUClCNCC
DNBlClCC
BNCUCSCU
DUDSDUDN
CUClCCCF
BUBSBUCU
CCCFCFCF
CFCDCUCS
BFBFBDBl
BFBDBUCU
BUBNCUCS
CSDNBlBU
BUClCSCU
BDBUCUDU
CDCUCSCU
BCBFBFBF
BUCUDUDN
BFBFBFBD
BFBFBDBU
CUDUDSDU
CFCFCUCF
BUCUCSCU
BlBNBUBS
CFCFCFCS
BSBUBlCU
BlBUBlCU
CSCUClCN
CDCUDNBl
BUBlBUBN
DNBlBUBl
CSCUCNBl
ClCUCSDN
BUCUDNBl
DSDUDNBl
BUBSBUBl
CUCSCUDU
CUCSCUCl
CNBlBUBl
BSCCCFCF
CUCNBlBU
CNBlBUCl
CSCUDUDN
BNBUBSBU
BSBUClCU
CFCFCSCF
BlBUBSBU
ClCNCCCF
BUCUClCU
BUBSCCCF
CSCFCFCF
CDCUDUDN
CFCDCUDU
