DUBNBlBU
DUDSDSDS
CUDSDUDN
CSDUDSDU
BlBUCSCS
BSBUCUCS
DUDNAlBN
DNDlDUDN
CSCSCSDU
BSBUBSBS
BUBSBUBS
CSCSDUDS
CSCSCUDU
DSDSDSDN
DNBlBUBS
DSDSDNBl
DUDNBlBU
CSCUCSCS
BlBUCUCS
DSDUDSDU
BUCSCSCU
DSDSDUDN
BlBUBSBS
DUDSANBl
BUCUDUDS
DUDSDSDU
CNCUDUDS
CSDSDSDU
DSDUDNDl
CUClCNCU
DNBlBUCU
CUCSCUDU
ANBlBUBS
BSBUCSCS
BlBSBUBS
other
CUDSDSDN
CUDSDSDU
CSCUDUDS
BSBUCUDU
CSCUCSCU
BUCSCSCS
CSCSCSCU
AlBNBlBU
DSANBlBU
DUDNBlBS
CUDUDNBl
BSBUBSBU
DNDlDUDS
CSCUCSDS
BNBlBUBS
CUCSCUDS
BUBSBUCS
BNBlBUCU
BUBSBSBS
CSCUDUDN
BUCSCUCS
DSDSDSDS
DNBlBUCS
CUCSDUDS
BUCUCSCS
BSBSBSBU
DNAlBNBl
CSCUDSDS
ClCNCUDU
CSCSCSCS
DUDSDUDN
CSDUDSDS
DSDSDUDS
BUBSBUCU
CSCSCUCS
DUDNDlDU
CUCSDSDS
DSDUBNBl
CUCSCSCS
DlDUDSAN
DlDUDNBl
BSBSBUBS
DUDSDUBN
BSBSBUCU
DSDNBlBU
BUBSBSBU
CSCUCSDU
BUCUDUDN
CUDUDNDl
CUDUDSDU
BUCUCSCU
BlBUCSCU
CNCUDUDN
BUCUClCN
BSBSBSBS
DNBlBSBU
CUCSCUCS
CSCUDSDU
DSDUDNBl
BSBUCUCl
DSDSDSDU
DSDUDNAl
BSBSBUCS
DUDSDUDS
CUCSCSCU
DSDUDSDS
BlBUBSBU
DlDUDSDU
