CNBlBUBC
DUDSDSDS
CUDUDSDS
BUBCBDBU
BFBUBFBD
BDBlBUCU
CCCUCFCU
other
CUCSCUDN
CFCFCDCC
BDBUClCU
DFDUDDDU
BlBUBCBF
CUCFCUCD
BCBDBUBC
BSBUBCBU
CCCUCDCC
CFCFCFDF
CNBlBUBS
CFCUCFCU
BUBSBSBS
ClCUCCCF
CUCCCUCF
CUCSCSDN
CSCSCUDU
DSDSDSDN
DNBlBUBS
BUBNBDBU
DSDSDNBl
DUDNBlBU
CSCUCSCS
BFBFBDBl
BlBUCUCS
BSBUClCS
BFBDBUBS
BUBFBUBl
BUBDBUBS
BUBSClCS
BUBSBUBC
CFCFCDCU
BUClCUCC
BUBCBFBU
DNBlBUBC
CDCCCUCF
BUBNBUCl
DFDFDUDF
BSClCSCU
CUCCCFCU
BCBUBFBD
BUBCBUBF
BUBCBFBF
BlBUBSBS
BSBSBUBl
DNBlBUCU
BSBSBUCU
CUCSCUDU
BlBSBSBS
CFCFDFDF
CFCFCFCD
BUClCUCS
DSDSDSDU
CFCFCFCF
BUBFBUBD
BFBDBUBl
BlBSBUBS
CUClCUCS
CUCDCUDU
BUBFBDBU
CSCUDNBl
CUCDCUCS
CFCDCUCN
DFDFDFDU
BUBSBUCl
CSCUCSCU
CUCCCUCD
BNBDBUCl
CSCSCSCU
CFCUCFCF
CUCDCUCl
CSCSCUDN
DNBlBSBS
CSCUCCCU
BNBUClCU
CSCSDNBl
BFBDBlBU
CSCSCUCN
CCCFCUCF
CUDUDNBl
BUBSBSBU
CUCDCUCC
DSDNBlBS
DUDNBlBS
CFCDCUDN
BCBUBFBU
CUCCCFCF
CUCFCFCF
BSBUBlBU
CUDNBlBU
CUCNBlBU
BFBFBFBF
BCBUBFBF
BSBUBSBS
BDBUBlBU
BUBFBFBU
CFCFCFCU
DSDSDSDS
CDCUClCU
BlBUBCBU
CDCCCFCD
ClCUCSCU
BUCUCSCS
CDCUCNBl
BSBSBSBU
BlBUCUCl
BCBFBUBF
ClCUCCCU
CUClCUCC
CFCUCFCD
CSCSCSCS
BSBlBUCU
DSDSDUDS
BUBSBUCU
CSCSCUCS
DFDUDFDU
CUCDCCCF
CCCFCFCF
BUBSClCU
BDBUBSBS
BUBFBUBF
CFCDCUCS
CUCSCSCS
BDBUBCBU
BUBSBUBS
CFDFDFDF
CDCUDUDS
CUDNBlBS
BSBSBUBS
CSCUCCCF
DNBlBSBU
BSBUBSBl
BUClCSCU
CSCSCUCC
CDCUCSCU
BSBUBSBU
DDDUDNBl
BCBFBFBF
BSBUBSCl
CUCSCUCC
BFBFBFBD
BFBFBDBU
BlBUBNBU
CFCFCUCF
BSBUCUCC
BUCUCSCU
BDBUBSBU
BSClCUCC
BSBSBSBS
BFBUBFBF
CSCUCNBl
BFBDBUCl
BlBUBNBD
CUCFCUCF
CDCUDNBl
BUBlBUCU
CSDNBlBU
CDCUCCCU
BUBlBUBN
ClCSCUCS
CUCSCUCS
CCCFCDCU
BCCFCFCF
BFBUBlBU
CUCDCUDN
BSBUCUCS
BlBUBCCF
BFBUBDBU
DUDFDUDD
BFBUBFBU
CUCFCDCU
CSCUDUDN
CFCUCDCU
CCCUCDCU
BUBSBlBU
BlBUBCBD
BSBUClCU
BFBFBUBF
CUCSCSCU
DSDUDSDS
BlBUBSBU
DUDDDUDN
BUCUCCCU
BUCUClCU
BUBCCFCF
CDCUCSCS
CDCUDUDN
CFCDCUDU
CFCDCCCU
