DNBlBCBF
BUBFBFBF
CUDSDUDN
BFBFBDCU
BlBUBSBS
CUClCNCS
CCCUCFCU
DCDFDFDD
CFCFCDCl
BDCUClCU
CFCFCFCF
BUBFBUBF
CUCFCUCD
ClCNCUCC
CCCUCFCF
ClCUCNCC
BSBUBCBU
CFCUCFCU
BUBSBSBS
BUBSBUBS
CUCCCUCF
CSCUDSDU
CFCUCFCD
DNBlBUBS
ClCNClCU
CDCUClCU
DUDNBlBU
CSCUCSCS
CNClCUCS
BlBUCUCS
BDBUCUCS
CDCUClCN
BFBDBUBS
BUBDBUBS
CUCFCFCU
BUBSBUBC
CFCFCDCU
BUCSCUCS
BUClCUCC
CUCNCCCU
BSBUBSBF
DNBlBUBC
CSCSCUDU
BUBSBUCl
BCBFBFBS
CUCCCFCU
CSCUCSCC
ClCNCUDN
BUBCBUBF
BUBCBFBF
CNCUCCCF
CUCFCFCD
CNCUDNBl
ClCCCFCF
CSCUDUDC
BSBSBUBl
CUClCNCU
DNBlBUCU
BlCUCSCU
BSBUBlCU
BSBSBUCU
CUCSCUDU
CUCSCCCU
BFBUBFBF
CFCFCFCD
DUDFDDDN
CNCSCSCU
CSCCCFCF
BUBFBUBD
CUDUDFDD
DUDNBlBC
BlBSBUBS
BUBlCUCS
CUClCUCS
CUCDCUDU
CSCUClCU
CSCSCUCl
CUCDCUCS
CSCSCSCS
CSCUDUDS
BSBUBCBF
CSCUCSCU
CSCSCUCC
CUCCCUCD
BlBSBUCU
CSCSCSCU
CFCUCFCF
CUCDCUCl
BSCCCUCF
DNBlBSBS
DDDNBlBU
BlBUBCBF
CSCCCUCS
DUDNBlBS
BlBSBUBC
CNCUCSCS
CUClCUCC
CCCFCUCF
CUDUDNBl
BSBUBSBU
CUCSCFCS
CUCDCUCC
BFBUBSBU
BUBFBFBD
BCBUBFBU
CSCUCCCU
CUCCCFCF
CUCFCFCF
CSCFCSCU
BSCUCFCF
CUDNBlBU
CNCCCUCF
CUCSCUDS
BFBFBFBF
CFCFCUCD
BCBUBFBF
BSBUBSCl
BSBUBSBS
CCCUCSCF
BSBSCCCU
BUBFBFBU
CSCUDUDN
CFCFCFCU
BSBUCSCU
CFCUDUDD
ClCUCNCU
BlBUBCBU
BlBSBSBU
BFBFBDBS
ClCUCSCU
BUCUCSCS
BSBSBSBU
other
CUCSCCCF
CCCFCUCD
BCBFBUBF
ClCUCCCU
CDCUCCCF
BDBSBUBS
ClCNCSCS
ClCNCUDU
CUDUDDDU
DUDSDUDN
BFBFBSCU
CUDUDCDF
BUBSBUCU
CUCNCUDU
CCCFCFCF
CSCUClCN
BDBUCUCC
BlBCBFBU
BSBSBSCC
CSClCUCS
BUCUCCCF
CFCDClCU
CDCUClCC
CFCDCUCS
CUCSCSCS
BUBSBFBU
ClCUCCCF
CDCUDUDS
CFCFCUDU
BSBSBUBS
CSCUCCCF
DNBlBSBU
BFBSCUCF
CUClCUCN
CUCNCUCS
CDCUCSCU
BUBSBSBU
DDDUDNBl
BFBDBSBU
CFCSCUCS
BCBFBFBF
BSBFBUBF
CFCUDUDF
CUCSCUCC
BFBFBFBD
BFBFBDBU
CUDUDSDU
DFDDDNBl
CDClCUCC
CFCFCUCF
BSBUCUCC
BUCUCSCU
BSClCNCl
BDBUBSBU
CUClCCCF
CNCUDUDN
BUCUClCN
CSCUCFCU
BSBSBSBS
BUBFBUBS
CSCSCUCS
BSBSBUCl
CUCFCUCF
ClCUCSCS
CFCDCUCl
CCCUCFCD
CSCUCSCl
BSBUClCN
CUCSCUCS
DFDFDDDN
CSCUCSCF
CUCSClCU
BSBUCUCS
DSDUDNBl
BSBUCUCl
BFBUBDBU
BUClCNCl
CNCUCCCU
BFBDCUCl
CUCSCUCl
BUBDBUCU
DUDCDFDF
BFBUBFBU
CUCFCDCU
CCCFCFCD
BSBSBUCS
CFCUCDCU
CCCUCDCU
BSBUClCU
BFBFBUBF
CUCSCSCU
BlBUBSBU
DUDDDUDN
BCBFBFBU
CFCSCUCF
BUCUCCCU
BUCUClCU
BUBSClCN
BFBFBFBU
CDCUDUDN
CFCDCUDU
