ClCUClCN
CUDSDUDN
CUClCSCS
BUBSBSCU
other
DUDNAlAN
CUCSCSCS
BUBlBNBU
CNDUDNBl
BUBSBUBS
CSCSCUDU
BlBUBlBU
BNBUCUCS
DNBlBSBU
DlDNDUDN
ClCNClCU
DUDNBlBU
ANBlBUCl
CSCUCSCS
BNClCUCS
CNClCUCS
BlBUCUCS
ClCNCUCS
CUCSCSDU
DSDUDSDU
DNBlBUCl
BUBSCUCl
DSDSDUDN
BUCUDUDl
CNCUDUDl
DUDSDSDU
ClCSCSCU
DUDlDNDU
BUCUClCS
DNBlBlBU
BUCUClCl
BlBUBlBN
DNAlANBl
ClCUDUDS
CUClCNCU
DNBlBUCU
ClCUCNDU
CUCSCUDU
BUClCUCS
CSCSCUCl
DUDNBlBl
BlBSBUBS
CUClCUCS
CUCSClCN
ClCSCUDU
CSCUClCU
CUCSDUDN
ClCUDSDU
DNBlBUBS
BUBSBUCl
BSBUCUDU
CSCUCSCU
ClCUCNCl
CSCSCSCU
ClCNClCS
ClCUCSCU
DlDNDUDS
DUDNBlBS
CUDUDNBl
BlBUClCU
CUDSDUDl
CUCSCUDS
CNCUDUDS
BSBUBSBS
ClClCUCN
CUDUDSDN
CUDSDUDS
CNClCSCU
BSBSCUDU
BUCSCUCS
CUCNDUDN
DNBlBUCS
ClCUCNCU
BUClCUDU
BSCUDUDN
BUCUCSCS
BlBUCUCl
CSCUDUDS
BUClCUCl
BUBNBUBS
BNBUCUCl
ClCNCUDU
DUDSDUDN
BlBNBUBS
BUBSBUCU
CUCNCUDU
AlANBlBU
ClCUDUDN
BUBlBNCl
DSDUDSDN
BSCUClCU
BSBSBUCU
CUClCUCN
BlBlBUBN
DSDNBlBU
BlBNClCU
CSCUCSDU
CUClCNCl
DlDUDNDU
CUCNClCU
BlBUBSCU
CUDUDSDU
BlBUBNBU
BUCUCSCU
BlBUCSCU
CUDUDlDN
CSDUDNAl
CSCSCUCS
DUDSDNBl
CSCUClCN
ClCUCSCS
CSCSDUDN
CUClCUDU
CSCUCSCl
BSBUBSBU
BUBlBUBN
CSDUDNBl
CSClCNCU
CUCSCUCS
DNBlBUBl
CSCUDSDU
DSDUDNBl
BSBUCUCl
DNDUDSDU
DUDlDUDN
DNDUDNBl
BUClCNCl
DUDNDUDN
CUCSCUCl
CSCUDUDN
BUClCUDS
DUDSDUDS
BNBUBSBU
BSBUClCU
CUCSCSCU
DSDUDSDS
BlBUBSBU
CUClClCU
BUBNBUCU
BlBUClCN
BUCUClCU
DSDUDlDU
BUBSBSBU
CNCUCSCU
