DUDSDSDS
CUDSDUDN
BSBUBSCU
BSBUCUCl
BSCUCSCU
CUCSCUDN
CSDNAlBN
CNBlBUBS
BSBUBSBS
CSCSCUCl
BUBSBUBS
CSCUDNBl
CSCSCUDU
DSDSDSDN
DNBlBUBS
CNCUCNBl
DSDSDNBl
DUDNBlBU
CSCUCSCS
CSCSCNBl
BlBUCUCS
ClCNCUCS
CUCNBlBS
BUBSCUCS
BlBUBSBS
BSBUBSCS
BSBUCUCS
CSCUCNAl
CUClCNCU
DNBlBUCU
CUCSCUDU
CSCSCSCN
BSBUCSCS
BlBSBUBS
other
CUDSDSDU
CUCSCSDN
CSCSDNAl
BSBUCUDU
CSCUCSCU
BUCSCSCS
CSCSCSCU
AlBNBlBU
CSCSCUDN
DUDNBlBS
CSCSCUCN
CUDUDNBl
BUBSBSBU
CUCSCUCN
DSDNBlBS
BNBlBUBS
CUDNBlBU
CNAlBNBl
CUCSCUDS
BUBSBUCS
BNBlBUCU
BUBSBSBS
BSBSBUCS
BUBSCSCU
BSBSCUCS
BUCUCSCS
BSBSBSBU
DNAlBNBl
CSCUDSDS
CSCSCSCS
ClCNCUCN
DSDSDUDS
BUBSBUCU
CSCSCUCS
CUCSCSCS
BSBSBUBS
BSBSBUCU
CSCNBlBU
CNCUCSCS
BSBUBSBU
BUCUDUDN
BUCUCSCU
BUCUClCN
BSBSBSBS
CSCUCNBl
DNBlBSBU
CSCUClCN
BSBSBSCU
CUCSCUCS
CSCUDSDU
DSDUDNBl
CNBlBSBU
CUCNBlBU
CSCUDUDN
BSCSCUCS
CUCSCSCU
DSDUDSDS
BlBUBSBU
CUCNAlBN
