BUBSBSBS
BUBSBUCS
BUBSBSCU
BUCUCSCU
BUCSCUCS
BSBUCSCU
BSCUCSCS
BSBSCUCS
BUBSBSBU
CNBlBSBS
BSBSBSBS
BlBSBSBU
CSCUCNBl
BSBSBSCU
BUCUCSCS
BSBSBSBU
BlBSBUBS
other
CNBlBUBS
CUCSCUCS
BSBUBSBS
CNBlBUCU
BUBSBUBS
BSBUCUCS
CNBlBSBU
CSCUCSCU
BUBSBUCU
CSCSCUCS
CSCSCSCU
CSCUCSCS
CUCNBlBU
BlBUCUCS
BSBUCUCN
CUCSCSCS
CSCSCUCN
CUCNBlBS
BSCSCUCS
CSCSCSCS
CUCSCUCN
CUCSCSCU
BSBSBUBS
BlBUBSBU
BlBUBSBS
BSCUCSCU
BSBSBUCU
BUBSCSCU
BSBUBSCS
BSBUBSBU
BUCUCNBl
