BSBUBSBS
CUCSCNBl
BUCUCSCU
BSCUCSCU
BSBSCUCS
BSBSBSBS
CSCSCSCN
CSCUCNBl
BSBSBSCU
BUCUCSCS
BSBSBSBU
BUCSCUCS
CNBlBUCS
BlBSBUBS
other
CNBlBUBS
CUCSCUCS
BUBSBSBS
CSCSCSCS
BUBSBUBS
BSBUCUCS
CNBlBSBU
CSCUCSCU
BUBSBUCU
CSCSCUCS
CUCSCSCN
CSCSCSCU
CSCUCSCS
CSCUCSCN
CSCSCNBl
CUCNBlBU
BlBUCUCS
CNBlBUCU
BSBUCUCN
CUCSCSCS
CSCSCUCN
CUCNBlBS
BUBSBSBU
CUCSCUCN
CUCSCSCU
BSBSBUBS
BlBUBSBU
BlBUBSBS
BlBUCSCU
BSBSBUCU
CSCNBlBU
BSBUBSBU
BUCUCNBl
