BUCUDUDN
DSDUDNBl
DUDSDSDS
CUDUDSDU
CUDUDSDN
CUDUDSDS
BSBUCUDU
BUCUCSCU
DUDSDNBl
DNBlBUCU
DSDSDSDS
BUCUDUDS
BSBUCUCS
CUCSCUDU
BUBSCSCU
DSDUDSDU
BSBSBSBS
CSCSCUCS
DSDSDSDU
DNBlCUDS
DUDSDUDS
BUCUCSCS
BUBSCSCS
BSCSCSCS
BlBSBUCU
BSBSBSBU
CSDUDNBl
other
DUDNBlCU
BlCUDSDU
CUCSCUCS
CUCSDUDN
BUBSBSBU
BUBSBUBS
DUDSDUDN
BlBSBUCS
CSCUCSDU
CSCUDUDS
CSCSCUDU
DSDSDUDS
BUBSBUCS
CSCUCSCU
BUBSBUCU
DNBlBUBS
CUDSDUDS
BSBUCSCS
BUCSCSCS
CSCSCSCU
DSDNBlBU
DUDNBlBU
BSBSBUCU
CSCUCSCS
BSBUBSBS
BSCSCUCS
BlBUCUCS
DUDNBlBS
CSCUDUDN
DUDSDSDN
BUCSCUDU
CUCSCSCS
BUCSCSCU
CUDUDNBl
DSDSDUDN
CSCSCSCS
CUCSCSCU
DSDUDSDS
BlBUBSBU
BlBUBSBS
DUDSDSDU
DNBlBSBU
DSDSDNBl
BSBUCSCU
BSBSBUBS
BSBUBSCS
BSBUBSBU
BUBSBSBS
BlBUBSCS
