CDCUCSDN
ClCSCUCS
BUBCBFBD
BUBFBFBF
BCBFBFBD
BFBUBFBD
CSCFCFCU
BFBFBFBF
CCCUCFCU
other
BSClCUCC
CFCFCDCC
CFCFCFCF
CFCUCFDF
BlBUBCBF
CFCSCFCF
CCCFCUCF
BUBCBSBF
CCCUCFCF
BSBUBCBU
CCCUCDCC
BUBDBUBC
CUCFCDCC
BSBUBDBU
CFCUCFCU
BUCSCSCU
BCCUCFCD
BCCFCFCF
BDBUBCCU
CUCCCUCF
BUBSBUBD
CDCCCDCU
CFCUCFCD
CDCUCCCD
BUBlCUCC
BCBFCFCS
DNBlBUBS
BlBCBFBF
CSCUCCCS
CUDNBlBC
BUBDBUCU
CSCUCSCS
CUCCCDDC
CUCDCUDC
CSCUCFCF
BFCFCSCF
BFBDBUBS
CCCDCCCF
BUBDBUBS
CUCFCFCU
CUCCCDCC
BUClCCCU
BUBSClCS
CFCUCSCD
CCCDCUCC
BUBSBUBC
CFCFCDCU
CFCFCUCS
BUBCBFBU
CDDCDDDU
CUCCCFCD
DNBlBUBC
BUCUCCCS
CDCCCUCF
BDBUBSBS
ClCUCCCF
BUBFBDCU
BSClCSCU
BUCUClCS
CUCCCFCU
BCBUBDBU
BCBUBFBD
BUBCBUBF
BUBCBFBF
CUCFCFCD
BFBDBUBC
BUBSBUCS
BSBSBUBl
CFCDDNBl
BSBUClCC
CUCSCUDU
CFCSCFCU
BFBUBFBF
CDDNBlBC
CFCFCFCD
BUClCUCS
BSBUCSCS
BDCUCCCF
CFCUCDCC
BUBFBUBD
BFBDBUBl
DUDNBlBC
BSBUBCBF
BCBUBSBU
BlBSBUBS
CUClCUCS
CUCDCUDU
BUBFBDBU
BUClCSCU
BDBUBSCl
CSCUDNBl
CUCDCUCS
CUCSDNBl
CDCCCFCF
CCCFCSCF
CFCUCFCF
DNBlBCBU
ClCCCFCF
CSCUCSCU
CUCCCDCU
CUCCCUCD
BDBUBlBC
CSCSCSCU
CDCUCCCU
BDBUBCBF
CSCSCUDN
CFCDCCCF
DCDUDFDF
DDDNBlBU
CSCUCCCU
DUDNBlBS
BFBDBUCC
BlBCBUBS
CDCUCSCU
CUClCUCC
CUCFCUCD
CUDUDNBl
BFBFBDBU
CDCUClCU
CDCUDNBl
CUCDCUCC
BCBSBFBD
BFBUBSBU
BlBUBSCl
CDCUDCDU
CFCDCUDN
BCBUBFBU
BCBFBDBU
CUCCCFCF
CUCFCFCF
CDCCCUCD
BUBCBFCF
ClCCCUCF
CUDNBlBU
CUCFCDCU
DNBlBCBF
BCBFBFBF
BDCUClCU
BDBUCUCl
CFCFCUCD
BCBUBFBF
BSBUBSBS
BUBCBUBD
BUBFBFBU
BUBCCUCF
CFCFCFCU
BDBUClCU
DNBlBUCS
BlBUBCBU
BUCCCFCU
BUBDBUCl
ClCUCSCU
BSBFBDBU
BFBDBUCl
BUCUCSCS
CUCFCDDN
BUBlBCBF
BCBFBUBF
ClCUCCCU
CDCUCCCF
CSCUClCS
CSCFCUCS
CDCUClCC
BUBDCUCC
CSCDCUCS
CSCDCCCD
CSCUCCCD
CUClCCCF
BUBSBUCU
CCCFCDCS
CUCCCSCU
CCCFCFCF
CUCDCCCU
BlBUBCCF
BlBCBFBU
CDCCCFCS
DFDFDDDU
CUCFDFDF
CFCDCUCS
BFBFBUBD
CUCSCSCS
DFDDDUDN
BDBUBCBU
BlBCBUBF
BFBDBUCU
BSClCUCS
CSCUCCCF
BDBUBSBU
BUCSCUCl
CSDNBlBU
BDBUCCCF
CSCSCUCC
CDCSCUCC
CCCFCDCC
BlCUCCCF
BUBSBSBU
DDDUDNBl
CFCFCDCS
BDBUCUCS
ClCSCUCC
CSCSCUDU
CUCSCUCC
BFBFBFBD
DUDFDFDD
CUClCSCU
CFCDCUCC
CFCFCUCF
BUCUCSCU
BUBSBUBS
BlBUCSCU
CUDCDUDF
CCCSCUCF
BSBUBlCU
CSCUCFCU
CFCDCSCU
BUBFBUBS
DNBlBSBU
BSBSBUCl
BFBUBFBU
ClCUCSCS
CCCFCUCD
CFCDCUCl
CCCUCFCD
CDCSCUCS
BDBUClCS
BSBUBSBU
CCCDCUDU
BFBUBDCU
CUCSCUCS
BUBSBUBF
DFDFDDDN
BSBUBCBS
CCCFCDCU
CUCDCUDN
BSBUCUCS
CCCFCFCU
CUCDCUCl
CUCSCDCU
BFBUBDBU
BSBUBCCF
CUCSCUDN
BUBFBUBF
BFBDCUCl
DUDNBlBU
CUCFCUCF
BDBUCUCC
BSBUBFBF
CCCFCFCD
CSCUDUDN
CFCUCDCU
CCCUCDCU
DCDDDUDN
BUBSClCU
BFBFBUBF
CUCSCSCU
BlBUBSBU
CCCDDCDD
CFDFDFDD
DFDDDNBl
BCBFBFBU
CUCSCDCC
BUBCCFCF
BFBFBFBU
CDCUCSCS
CDCUDUDN
CFCDCUDU
CFCDCCCU
