BlBUBlBU
CNDlDNAl
BlBUCSCS
DNAlAlAN
DlDNBlBN
CNDlDNBl
DlDNDlDl
CNCSCUCS
BUBSBSBS
CNBlBUCU
BUBSBUBS
BNBlBNBl
CNBlBSBS
DNBlBUBS
ANBlBSBS
CSCUCSCS
DlDNAlAl
BlBUCUCS
DNDlDNBl
BUCSCSCU
CUCNBlBS
ANBlBUBl
AlANBlBS
BUBSCUCS
BUCUCNAl
ANAlANAl
BlBUBSBS
CSCNAlAN
BlBNBlBS
CUCNDlDN
CNAlANBl
ClCNDlDN
AlANAlAN
DNAlANBl
BSBSBUBl
DNBlBUCU
BSCUCSCS
BSBSBUCU
ANBlBUBS
BlBSBSBS
BUBNBUBl
CUCNAlAN
BlBSBUBS
CNAlAlAN
other
AlAlANAN
BNBlBSBS
BUBSBUCS
CSCUCSCU
CSCSCSCU
CUCNAlAl
BSBUCUCN
DNDlDlDN
CNAlANAl
CSCSCUCN
BlBNBlBN
CUCSCUCN
BSBSBSBU
CSCUCNDl
DlDNBlBU
BNBlBUBS
CUClCNCS
BNBlBUCU
BSBUBSBS
CNBlBSBU
BUCSCUCS
BSBUCSCU
CNClCNDl
BlBSBSBU
CNDlDNDl
BUCUCSCS
ANBlBUCS
AlANBlBN
AlANANBl
CSCSCSCS
ANBlBNBl
DNDlDNDl
BUBSBUCU
CSCSCUCS
CSCUCNAl
ANAlANBl
CUCSCNAl
CUCSCSCS
BSBSBUBS
DNDlDNAl
DlDNAlAN
BSBUBSBU
BlBUBSCU
CUCNClCN
BlBUBNBU
BUCUCSCU
DlDNDlDN
CSCUCNCl
BUCUClCN
BNBUCUCS
DlDlDNDN
CSCUCNBl
DNBlBNBl
BSBSBSBS
DNDNBlBN
ClCNCSCU
BUBlBUBN
CUCSCUCS
DNAlANAl
BSBUCUCS
BSBUCUCl
ANANBlBU
DlDNDNBl
CSCUCSCN
CUCNBlBU
BUCUCNDl
BSBUBlBU
AlANBlBU
BNBUBlBU
CUCSCSCU
BlBUBSBU
BUBNBUCU
BlBNBlBU
BUBSBSBU
