BSBUBSBS
CUCSCNBl
BSBUBSCU
BUCUCSCU
BUBSCSCU
BSCUCSCS
BUBSBSBU
BSBSBSBS
CSCUCNBl
BUCUCSCS
BSBSBSBU
other
CNBlBUBS
CUCSCUCS
BUBSBSBS
CNBlBUCU
BUBSBUBS
BSBUCUCS
CNBlBSBU
CSCUCSCU
BUBSBUCU
CSCSCUCS
CSCSCSCU
CSCUCSCS
CSCUCSCN
CUCNBlBU
BlBUCUCS
BSBUCUCN
CUCSCSCS
CSCSCUCN
CUCNBlBS
BSCSCUCS
CSCSCSCS
CUCSCUCN
BUBSCUCS
CUCSCSCU
BSBSBUBS
BlBUBSBU
BlBUBSBS
BSBSBUCU
CSCNBlBU
BSBUBSCS
BSBUBSBU
BUCUCNBl
