CSCUCDCS
CCCUCSCS
CNBlBUBC
CUCCCFCF
BUClCSCS
CUCFCFCU
BlBUBlBU
CUCSCCCS
BSBUBSCU
CUCDCUCN
BFBUBFBD
CUCNCUCN
CCCUCFCU
other
CUCSCUDN
CFCFCUCD
BDBlBUBS
BDBUClCU
BCBUBFBU
BSBUBCBU
BNClCUCC
BlBUBCBF
CUCFCUCD
BSClCUCS
CCCUCFCF
CSCSCDCU
BFBUBDBl
BUBDBUBC
CUCNBlBC
BUBFBUBD
CNBlBUBS
BSBDBSBS
BUBSBCBU
CSCSCUCl
BUBSBUBS
CUCCCUCF
BCBFBFBD
BSBSBSCl
CSCUDNBl
CFCUCFCD
CNBlBSBS
BUBlBUBS
CCCDCCCU
CNCUCNBl
CDCUClCU
BUBFBSBU
BUBDBUCU
CSCUCSCS
BDBUBlBU
CSCSCNBl
BUBCBSBS
CUCNCUCC
BSBUBSBN
BFBDBUBS
BUBDBUBS
CUCNBlBS
BUBSCUCl
ClCSCUCC
BUClCCCU
BSBUClCS
BFBFBUBS
CFCDCUCN
CUCFCDCU
BUBSBUBC
BlBUBSBS
BUClCUCC
CUCSCDCS
BlBUClCS
CDCSCSCS
CCCUCSCU
CUCDCSCS
CCCSCUCS
CUCCCDCU
BSBSBUBS
BUBCBFBU
BUBSBUCl
CUCCCFCU
CSCUCSCC
BCBUBDBU
BUBCBUBS
BUBCBUBF
BUBCBFBF
BlBUCUCC
CFCFCDCU
CSCUCDCU
BFBDBUBC
CCCDCUCS
CNBlBSBU
BSBSBUBl
CUClCNCU
CSCUCSCU
CUCNCUCS
CUCSCCCU
BlBSBSBS
CFCFCFCD
BUBSBDBU
BUClCUCS
BlBUClCC
BSBUBlBN
CUCCCUCD
BUBDBUCl
BCBUBSBU
BlBSBUBS
CUClCUCS
BUBFBDBU
CSCUClCU
BUClCSCU
BUBSBDBS
CDCUCCCD
CUCDCUCS
CUCFCDCS
CCCDCUCC
BCBUBlBU
CUClCUCN
CUCCCUCS
CUCSCUCF
CUCSCSCN
BSBDBSBU
CSCSCSCU
CDCUCCCU
CUCDCUCl
BCBSBSBU
CUCCCSCF
BSBSBUBF
CSCUCCCU
CSCCCUCS
BUCUCCCD
CSCCCSCU
CSCSCUCN
CCCFCUCF
BUCUCCCU
BUBSBSBU
CUCSCUCN
CUCDCUCC
BFBUBSBU
BNBUBCBU
ClCSCUCS
CFCSCUCS
BSBUBFBS
CCCFCFCD
CDCCCUCD
BSBUBlBU
CUDNBlBU
BlBUBSBD
ClCCCUCD
BDBSBSBS
BDBUCUCl
BUBNBUBC
BCBUBFBF
BSClCSCS
BSBUBSBS
CUCSCNBl
BUBSBSBS
BUBCBUBD
BUBFBFBU
CUCCCDCC
CSCFCSCU
BCBUBFBD
CSCSCCCU
ClCUCNCU
BlBUBCBU
CCCSCUCD
CSCUCFCF
ClCUCSCU
BUCUCSCS
CDCUCNBl
BSBDBUBS
BSBSBSBU
BSBUBDBU
CSCUCSCD
BCBFBUBF
ClCUCCCU
BUBNBUBS
CUClCUCC
BSBUBSBC
BlBNClCU
CSCSCSCS
CCCSCFCS
CSCSCSCD
ClCNCUCN
CSCUCCCD
BUBCBDBU
BUBSBUCU
CSCSCUCS
CSCDCSCU
BlBCBSBU
BCBSBSBS
CNCUCCCU
BUBSClCU
BDBUBSBS
BDBCBUBD
BUBFBUBF
BFBUBDBU
BSBUBFBD
BDBSBUBS
BUCUCCCF
CUCSCUCD
BUBlBNCl
BDBUBCBS
CFCDCUCS
CUCSCSCS
BSBCBUBl
CDCSCNBl
BDBUBCBU
BSCUClCU
BFBDBUCU
BUBlBUBC
BUBDBlBU
BUBSBNBU
CSCDCUCS
CSCUCCCF
CSCSCSCC
BFBSBUCU
BSBSBUCU
BSBUBSBD
CSCNBlBU
CNBlBCBS
CSCSCUCC
CDCUCSCU
BSBUBSBU
BSBSClCC
BDBUCUCS
DNBlBUBC
ClCCCUCS
BSBUBSCl
CUCSCUCC
BFBFBDBU
CCCDCUCN
BlBUBNBU
BSBUCUCC
BUCUCSCU
BDBUBSBU
BCBSBUBD
BSBSBUBC
BSBSBSBS
BFBUBFBU
CSCUCNBl
CSCDCSCN
BSBSBUCl
BSBNBUBS
CSCUClCN
ClCUCSCS
BUBlBUCU
CCCUCFCD
CDCSCUCS
BUBlBUBN
BSBSBDBS
BSBSBUBD
CUCSCUCS
ClCUCCCS
BSBUBCBS
BSBUCUCS
BSBUCUCl
CUCFCFCF
BUBSBUBl
BSBSBlBU
BSClCCCU
BFBDBCBU
CSCNBlBS
CUCSCUCl
CNBlBUBl
CSCUCSCN
BUBDBUBl
BDBUCUCC
CUCNBlBU
CNBlBUCl
CFCUCDCU
CCCUCDCU
BlBUBCBD
BNBUBSBU
BSBUClCU
BUBSClCS
BlBCBUBD
BSBSBSBl
CUCSCSCU
BUBSBSBD
CNCUCSCU
BlBUBSBU
CSCUCNCU
CFCDCSCU
BUBFBDBC
BUCUClCU
CSCCCUCF
BCBDBUBS
CUCSCSCD
ClCSCSCS
CDCUCSCS
BSBlBUCU
