CNBlBUBC
BUBFBFBF
BSBUBSCU
BSBUCUCl
CFCFCSCU
BDBUCUCl
CCCUCFCU
other
CUCSCUDN
CFCFCFCF
BlBUBCBF
CFCSCFCF
CCCFCUCF
ClCNCUCC
CCCUCFCF
BUBDBUBC
CNBlBUBS
CDCUCCCF
BCBDBSBC
BUBSBSBS
BUBSBCBD
DNBlBUBl
CDCNBlBU
BUBSBUBS
BDClCUCS
CSCSDUDS
BlBUBFBU
CFCUCFCD
CDCUCCCD
BUBlCUCC
DNBlBUBS
DUDNBlBU
BFBFBSBF
CSCUCSCS
BDBCBFBF
BlBUCUCS
BFBDBUBS
BUBDBUBS
CUCFCFCU
BFBDBCBF
DNBlBUCl
CSCFCFCU
BFBFBDCl
BUBSBUBC
CFCFCDCU
BUClCUCC
BUBCBFBU
BlBUClCS
DNBlBUBC
BSBUCUCS
CSCCCFCU
CSCUCSCC
BCBUBDBU
BUBCBUBF
BUBCBFBF
BlBUCUCC
BlBUBSBS
BSBUBCBF
CUClCNCU
DNBlBUCU
BSCUCSCS
CUCSCUDU
CSDUDSDN
BFBUBFBF
BlBUBSBC
CFCFCFCD
BUClCUCS
CSCCCFCF
BUBFBUBD
DUDNBlBC
BlBSBUBS
CUClCUCS
CSCSCUCl
CSCUDNBl
BUBlBUBS
CUCSDNBl
CSCFCFCF
BUBSBUCl
BUBFBSBF
ClCCCFCF
CSCUCSCU
BFBFBUCl
BSBCBFBU
CSCSCSCU
CFCUCFCF
CSCSCUDN
CUCCCUCF
BUBFBUBF
BSBFBFBS
BFBSBFBF
CDCUCSCU
CSCSCUCN
CUDUDNBl
BUBSBSBU
CUCSCUCN
CFCUCSCF
CDCUCNBl
BSBCBDBS
BFBFBDBC
CFCDCUDN
BCBUBFBU
CSCUCCCU
CDCSCSCU
CUCCCFCF
CUCFCFCF
CFCFCDCN
BSBUBlBU
BFBUBSBF
CUDNBlBU
CUCFCDCU
BUClCSCS
BFBFBFBF
CFCFCUCD
BCBUBFBF
DNBlBCBU
BSBUBSBS
CUCSCNBl
BUBCBUBD
BUBFBFBU
CNBlBSBU
CFCFCFCU
BDBUClCU
CFCUCDCU
BlBUBCBU
CUCFCUCS
BUBDBUCU
ClCUCSCU
BSBFBDBU
BUCUCSCS
BCBFBUBF
BSBSBSBU
BlBUCUCl
CUCFCUCF
CUCSCCCF
BSBFBFBF
BFBUBFBS
ClCUCCCU
CFCUCFCU
CUClCUCC
BUBSBCBF
ClCUCCCF
CSCSCSCS
CUCCCDCS
BUBSBUCU
CSCSCUCS
CCCFCFCF
BFBUClCU
BDBUCUCC
BUBSBFBF
BUCUCCCF
CNBlBUCU
DNBlBUBF
BUClCCCF
CFCDCUCS
BFBFBUBD
CUCSCSCS
CSCSCSDU
BDBUBCBU
BlBCBUBF
BFBDBUCU
CFCDCSCS
BFBSBFBD
BSBSBUBS
CSCUCCCF
BSBSBUCU
CSDNBlBU
CSCNBlBU
CSCSCUCC
DSDNBlBU
BSBUClCC
BlCUCCCF
BSBUBSBU
BUBFBFBD
BlBUBSBU
BCBFBFBF
CSCSCUDU
CUCSCUCC
BFBFBFBD
BFBFBDBU
CSCFCUCD
CFCDCUCC
CFCFCUCF
BUCUCSCU
BDBUBSBU
CFCFCFCS
CFCSCFCU
CCCDCSCU
CUCNBlBS
BCBFBFBU
BCBFBUBS
CSCUCNBl
BFBDBUCl
DUDSDNBl
BFBUBFBU
ClCUCSCS
BUBlBUCU
CDCSCUCS
CSCUCSDN
CUCDCUCN
CFCDCNBl
CUCSCUCS
CUCFCFCD
BlBUBlCU
CSCUCFCF
CUCFCFCS
BUBSCUCS
CCCFCFCU
BFBDClCU
BFBUBDBU
BUBSBUBl
BSBSBUCl
CNCUCCCU
BSBCBFBF
CSCUCSCN
CSCUClCN
CUCNBlBU
CSCUDUDN
CDCUDNBl
ClCSCSCS
CUCSCFCF
BSBUClCU
BDBUBSBC
BFBFBUBF
CUCSCSCU
CFCFCSCF
CFCFCDCS
CDCUDUDN
CUCDCUCS
BUCUClCU
BDBSBCBF
BFBFBFBU
CDCUCSCS
CFCSCUCF
CFCDCUDU
